adrian = Adrian Holovaty <adrian@holovaty.com>
mtredinnick = Malcolm Tredinnick <malcolm@pointy-stick.com>
jacob = Jacob Kaplan-Moss <jacob@jacobian.org>
russellm = Russell Keith-Magee <freakboy3742@gmail.com>
gwilson = Gary Wilson Jr. <gary.wilson@gmail.com>
hugo = Georg Bauer <gb@hugo.westfalen.de>
ubernostrum = James Bennett <ubernostrum@gmail.com>
brosner = Brian Rosner <brosner@gmail.com>
lukeplant = Luke Plant <L.Plant.98@cantab.net>
kmtracey = Karen Tracey <kmtracey@gmail.com>
jbronn = Justin Bronn <jbronn@gmail.com>
telenieko = Marc Fargas <telenieko@telenieko.com>
ikelly = Ian Kelly <ian.g.kelly@gmail.com>
wilson = Wilson Miner <wminer@gmail.com>
mboersma = Matt Boersma <ogghead@gmail.com>
zgoda = Jarek Zgoda <jarek.zgoda@redefine.pl>
tekNico = Nicola Larosa <nico@teknico.net>
simon = Simon Willison <simon@simonwillison.net>
jezdez = Jannis Leidel <jannis@leidel.info>
toxik = Ludvig Ericson <ludvig.ericson@gmail.com>
jkocherhans = Joseph Kocherhans <jkocherhans@gmail.com>
ramiro = Ramiro Morales <cramm0@gmail.com>
aljosa = Aljosa Mohorovic <aljosa.mohorovic@gmail.com>
garcia_marc = Marc Garcia <garcia.marc@gmail.com>
jtauber = James Tauber <jtauber@jtauber.com>
ccahoon = Chris Cahoon <chris.cahoon@gmail.com>
Alex = Alex Gaynor <alex.gaynor@gmail.com>
zain = Zain Memon <zain@inzain.net>
Honza_Kral = Honza Král <honza.kral@gmail.com>
kkubasik = Kevin Kubasik <kevin@kubasik.net>
bbeck = Brian Beck <exogen@gmail.com>
jdunck = Jeremy Dunck <jdunck@gmail.com>
rjwittams = Robert Wittams <robert@wittams.com>
xian = Christian Metts <xian@mintchaos.com>
bouldersprinters = Boulder Sprinters <boulder-sprinters@djangoproject.com>
cell = NAME <USER@DOMAIN>
clong = NAME <USER@DOMAIN>
danderson = NAME <USER@DOMAIN>
dcf = NAME <USER@DOMAIN>
jpellerin = NAME <USER@DOMAIN>
rmunn = NAME <USER@DOMAIN>
utrebec = NAME <USER@DOMAIN>
aaugustin = Aymeric Augustin <aymeric.augustin@m4x.org>
timo = NAME <USER@DOMAIN>
julien = Julien Phalip <jphalip@gmail.com>
gabrielhurley = Gabriel Hurley <gabehr@gmail.com>
carljm = Carl Meyer <carl@oddbird.net>
SmileyChris = Chris Beaven <smileychris@gmail.com>
PaulM = Paul McMillan <Paul@McMillan.ws>
DrMeers = Simon Meers <simon@simonmeers.com>
claudep = Claude Paroz <claude@2xlibre.net>
idangazit = Idan Gazit <idan@gazit.me>
grahamd = NAME <USER@DOMAIN>
apollo13 = Florian Apolloner <florian@apolloner.eu>
loewis = Martin v. Löwis <martin@v.loewis.de>
arthurk = Arthur Koziel <arthur@arthurkoziel.com>
andrewgodwin = Andrew Godwin <andrew@aeracode.org>